...............................................................
...............................................................
...............................................................
...............................................................
...............................................................
...............................................................
...............................................................
...............................................................
...............................................................
..........O.......................................F............
.....____________________________________________________......
...............................................................
...............................................................
...............................................................
...............................................................
...............................................................