...............................................................
...............................................................
...............................................................
...............................................................
...............................................................
..........O....................................................
...............................................................
...............................................................
...............................................................
..................................................F............
.....____________________________________________________......
...............................................................
...............................................................
...............................................................
...............................................................
...............................................................